[INFO]
12	12	16	16
[ROWS]
0	0	0	0	0	0	0	0	0	0	0	0
0	0	0	0	0	0	0	0	0	0	0	0
0	0	0	0	0	0	0	0	0	0	0	0
0	0	0	0	0	0	0	0	0	0	0	0
0	0	0	0	0	0	0	0	0	0	0	0
0	0	4	4	0	0	0	0	0	0	0	0
0	0	0	0	0	0	0	0	0	0	0	0
0	0	0	0	3	3	0	0	0	0	0	0
0	4	0	0	3	3	0	0	0	0	0	0
0	0	0	3	3	3	0	0	0	0	0	0
0	0	0	3	3	3	0	0	0	0	0	0
1	1	1	1	1	1	1	1	1	1	1	1